Black_Lives_Matter	blm
Death_of_Abdirahman_Abdi	blm
All_Lives_Matter	blm
Alright_(Kendrick_Lamar_song)	blm
Murder_of_James_Craig_Anderson	blm
Assata%27s_Daughters	blm
2015_Baltimore_protests	blm
Black_Feminist_Future	blm
Death_of_Sandra_Bland	blm
Blue_Lives_Matter	blm
Shooting_of_Rekia_Boyd	blm
BYP100	blm
Campaign_Zero	blm
Shooting_of_Philando_Castile	blm
Shooting_of_Kenneth_Chamberlain_Sr.	blm
Shooting_of_Jamar_Clark	blm
Controversies_about_the_word_%22niggardly%22	blm
Shooting_of_John_Crawford_III	blm
Criminal_stereotype_of_African_Americans	blm
Shooting_of_Terence_Crutcher	blm
Shooting_of_Deborah_Danner	blm
Shooting_of_Jordan_Davis	blm
Shooting_of_Samuel_DuBose	blm
Ferguson_unrest	blm
Shooting_of_Jonathan_Ferrell	blm
The_Force_(2017_film)	blm
Shooting_of_Ezell_Ford	blm
Formation_(song)	blm
Frisco_Five	blm
Shooting_of_Korryn_Gaines	blm
Death_of_Eric_Garner	blm
Shooting_of_Ramarley_Graham	blm
Shooting_of_Oscar_Grant	blm
Shooting_of_Akai_Gurley	blm
Shooting_of_Dontre_Hamilton	blm
"Hands_up,_don%27t_shoot"	blm
Killing_of_Patrick_Harmon	blm
2015_shooting_of_Eric_Harris	blm
Shooting_of_Anthony_Hill	blm
Shooting_of_Meagan_Hockaday	blm
Shooting_of_Larry_Jackson_Jr.	blm
Death_of_Aiyana_Jones	blm
Shooting_of_Charley_Leundeu_Keunang	blm
Shooting_of_Charles_Kinsey	blm
Shooting_of_Joseph_Mann	blm
Shooting_of_Antonio_Martin	blm
Shooting_of_Renisha_McBride	blm
Shooting_of_Jeremy_McDole	blm
Shooting_of_Laquan_McDonald	blm
Shooting_of_Abdullahi_Omar_Mohamed	blm
Mothers_of_the_Movement	blm
Shooting_of_Paul_O%27Neal	blm
Shooting_of_Alfred_Olango	blm
Project_South_(organization)	blm
Shooting_of_Tamir_Rice	blm
Shooting_of_Timothy_Russell_and_Malissa_Williams	blm
Shooting_of_Tony_Robinson	blm
Death_of_Jonathan_Sanders	blm
SayHerName	blm
Shooting_of_Keith_Lamont_Scott	blm
Stay_Woke:_The_Black_Lives_Matter_Movement	blm
Shooting_of_Alton_Sterling	blm
Taking_a_Stand_in_Baton_Rouge	blm
Whose_Streets%3F	blm
Woke	blm
West_African_Ebola_virus_epidemic	ebola
Template:Ebola_virus_disease_epidemic	ebola
West_African_Ebola_virus_epidemic_timeline	ebola
West_African_Ebola_virus_epidemic_timeline_of_reported_cases_and_deaths	ebola
Body_Team_12	ebola
Cultural_effects_of_the_Ebola_crisis	ebola
Ebola_Medal_for_Service_in_West_Africa	ebola
Ebola_virus	ebola
Ebola_virus_disease	ebola
Ebola_virus_disease_treatment_research	ebola
Ebola_virus_epidemic_in_Guinea	ebola
Ebola_virus_epidemic_in_Liberia	ebola
List_of_Ebola_patients	ebola
Ebola_virus_disease_in_Mali	ebola
Ebola_virus_disease_in_Nigeria	ebola
Operation_United_Assistance	ebola
Ouse_to_Ouse_Tock	ebola
Post-Ebola_virus_syndrome	ebola
Responses_to_the_West_African_Ebola_virus_epidemic	ebola
RVSV-ZEBOV_vaccine	ebola
Ebola_virus_epidemic_in_Sierra_Leone	ebola
Ebola_virus_disease_in_Spain	ebola
United_Nations_Ebola_Response_Fund	ebola
Ebola_virus_disease_in_the_United_Kingdom	ebola
United_Kingdom_aid_efforts_for_the_2014_Ebola_epidemic_in_West_Africa	ebola
Ebola_virus_cases_in_the_United_States	ebola
VP40	ebola
Womey_massacre	ebola
2014_FIFA_World_Cup	fifa
2014_FIFA_World_Cup_Final	fifa
Adidas_Brazuca	fifa
2014_FIFA_World_Cup_awards	fifa
Belo_Horizonte_overpass_collapse	fifa
2014_FIFA_World_Cup_bids	fifa
Brazil_v_Germany_(2014_FIFA_World_Cup)	fifa
2014_FIFA_World_Cup_broadcasting_rights	fifa
Caxirola	fifa
List_of_2014_FIFA_World_Cup_controversies	fifa
Dar_um_Jeito_(We_Will_Find_a_Way)	fifa
2014_FIFA_World_Cup_disciplinary_record	fifa
Fuleco	fifa
2014_FIFA_World_Cup_Group_A	fifa
2014_FIFA_World_Cup_Group_B	fifa
2014_FIFA_World_Cup_Group_C	fifa
2014_FIFA_World_Cup_Group_D	fifa
2014_FIFA_World_Cup_Group_E	fifa
2014_FIFA_World_Cup_Group_F	fifa
2014_FIFA_World_Cup_Group_G	fifa
2014_FIFA_World_Cup_Group_H	fifa
2014_FIFA_World_Cup_group_stage	fifa
2014_FIFA_World_Cup_knockout_stage	fifa
2014_FIFA_World_Cup_marketing	fifa
Nippon_(song)	fifa
2014_FIFA_World_Cup_officials	fifa
One_Love	fifa
2014_FIFA_World_Cup_opening_ceremony	fifa
2014_FIFA_World_Cup_preparations	fifa
2013_protests_in_Brazil	fifa
2014_protests_in_Brazil	fifa
2014_FIFA_World_Cup_qualification	fifa
Road_to_Brazil	fifa
2014_FIFA_World_Cup_seeding	fifa
2014_FIFA_World_Cup_squads	fifa
2014_FIFA_World_Cup_statistics	fifa
Luis_Su%C3%A1rez_controversies	fifa
2014_FIFA_World_Cup_venues	fifa
2014_FIFA_World_Cup_Brazil_(video_game)	fifa
We_Are_One_(Ole_Ola)	fifa
You_Don%27t_Have_to_Live_Like_a_Referee	fifa